{
    "level":
    {
        "name":"bossRoom",
        "tileSet":"images/wall1.png",
        "tileSetAlt":"images/wall1_side.png",
        "tileFPL":1,
        "tileSize":[64,64],
        "tileMap":[
            [1,1,1,1,1,1,1,1,1,1,1,1,1],
            [1,1,0,0,0,0,0,0,0,0,0,1,1],
            [1,0,0,0,0,0,0,0,0,0,0,0,1],
            [1,0,0,0,0,0,0,0,0,0,0,0,1],
            [1,0,0,0,0,0,0,0,0,0,0,0,1],
            [1,0,0,0,0,0,0,0,0,0,0,0,1],
            [1,0,0,0,0,0,0,0,0,0,0,0,1],
            [1,1,0,0,0,0,0,0,0,0,0,1,1],
            [1,1,1,1,1,1,1,1,1,1,1,1,1]
        ],
        "enemy_list":[
            "royal_slime"
        ],
        "enemy_coords":[
            [600, 364]
        ]
    }
}