{
    "level":
    {
        "name":"shop",
        "tileSet":"images/wall1.png",
        "tileSetAlt":"images/wall1_side.png",
        "tileFPL":1,
        "tileSize":[64,64],
        "tileMap":[
            [1,1,1,1,1,1,1,1,1,1,1,1,1],
            [1,0,0,0,0,0,0,0,0,0,0,0,1],
            [1,0,0,0,0,0,0,0,0,0,0,0,1],
            [1,0,0,0,0,0,0,0,0,0,0,0,1],
            [1,0,0,0,0,0,0,0,0,0,0,0,1],
            [1,0,0,0,0,0,0,0,0,0,0,0,1],
            [1,0,0,0,0,0,0,0,0,0,0,0,1],
            [1,0,0,0,0,0,0,0,0,0,0,0,1],
            [1,1,1,1,1,1,1,1,1,1,1,1,1]
        ],
        "item_list":[
            1
        ],
        "item_coords":[
            [600, 350]
        ]
    }
}