{
    "level":
    {
        "name":"enemyRoom2",
        "tileSet":"images/wall1.png",
        "tileSetAlt":"images/wall1_side.png",
        "tileFPL":1,
        "tileSize":[64,64],
        "tileMap":[
            [1,1,1,1,1,1,1,1,1,1,1,1,1],
            [1,0,0,0,0,0,0,0,0,0,0,0,1],
            [1,0,1,0,0,0,0,0,0,0,1,0,1],
            [1,0,0,0,0,1,1,1,0,0,0,0,1],
            [1,0,0,0,0,1,0,1,0,0,0,0,1],
            [1,0,0,0,0,1,1,1,0,0,0,0,1],
            [1,0,1,0,0,0,0,0,0,0,1,0,1],
            [1,0,0,0,0,0,0,0,0,0,0,0,1],
            [1,1,1,1,1,1,1,1,1,1,1,1,1]
        ],
        "pickup_list":[
            3
        ],
        "pickup_coords":[
            [600, 360]
        ]
    }
}